NO ./assets/textures/no_wall.xpm
SO ./assets/textures/so_wall.xpm
WE ./assets/textures/we_wall.xpm
EA ./assets/textures/ea_wall.xpm

F 255,20,147
C 135,206,250

1111111111   
 1000000001 
 1011111101 
 1001000001 
1111S111011
  1000000001  
  1010111101  
 1000010001 
  1111111111 