NO ./assets/textures/no_wall.xpm
SO ./assets/textures/so_wall.xpm
WE ./assets/textures/we_wall.xpm
EA ./assets/textures/ea_wall.xpm

F 120,80,0
C 70,130,180


                           1111111111111111111111111
                          100000000000000000000000001
                         1000000000111110000000000001
                        10000000000000000000000000001
                       100001111110000001111110000001
                      1000010000100000010000100000001
                     10000000000000000000000000000001
                    100000000001111100000000000000001
                   1000000000000000000000000000000001
                  10000000000000000000000000000000001
                 1000000111110000000000001111100000001
                10000000000100000000000010001000000001
               100000000000000000000000000000000000001
              1000000000000000000000000000000000000001
             10000000000000000000000000000000000000001
            10000000000010100000000W000000000000000001
           10000000000000000000000000000000000000000001
          1000000000000000000000000000000000000000000001
         10000000000000000000000000000000000000000000001
        1000000000000000111110000000000000000000000000001
       10000000000000001000100000000000000000000000000001
      1000000000000000000000000000000000000000000000000001
     100000000000000000000000000000000000000000000000000001
    1000000000000000000000000000000000000000000000000000001
   100000000000000000000000000000000000000000000000000000001
  1000000000000000000000000000000000000000000000000000000001
 111111111111111111111111111111111111111111111111111111111111



