NO ./assets/textures/no_wall.xpm
SO ./assets/textures/so_wall.xpm
WE ./assets/textures/we_wall.xpm
EA ./assets/textures/ea_wall.xpm

F 120,80,0
C 70,130,180


                           1111111111111111111111111
                          100000000000000000000000001
                         1001111111111100000000000001
                        10100000000001000000000000001
                       100001111111000001111110000001
                      1000010000100000010000100000001
                     10000000001000000000000000000001
                    100000000001111100000000000000001
                   1000000000000000000000000000000001
                  10000001111000000000000000000000001
                 1000000111110000000000001111100000001
                10000000000100000000000010001000000001
               100000000000000000111000000000000000001
              1000000000111111111111110110000000000001
             10000000001000000000000101100000000000001
            1000000000100111110010011100000000000000001
           1000000000100000000010000000000S000000000001
          1000000000111111111111111111110000000000000001
         10000000000000000000000000000000000000000000001
        10000000000000001111100000000111000001111100001
       1000000000000000100010000000011110000011111100001
      10000000000000000000000000000110110000000011110001
     100000000000000000000000000001100000000111111000001
    1000000000000000000000000000011111111100111111000000111
   100000000000000000000000000000000011100001110000000000001
  1000000000000000000000000000000000001100000111110000000001
 111111111111111111111111111111111111111111111111111111111111



