NO ./assets/textures/no_wall.xpm
SO ./assets/textures/so_wall.xpm
WE ./assets/textures/we_wall.xpm
EA ./assets/textures/ea_wall.xpm                                                                          

F 0,0,0


C 173,216,230









        1111111111111111111111111
        1000000000110000001000001
        1011000001110000000000001
        1011000000000000000010001
111111111011000001110000000000001
1N0000000110000011101111101111111
11110111111110011100000010001 
11110111111111011101010010001
11000000011101011100000010001
10000000000000001100000010001
10000000000000001101010010001
1100011101000111110111100111
111101 11110101101111010001
111111 11111111111111111111